%%%%%%
% %%%%
%  .%% 
%% % %	
%P   %
%%%%%%