%%%%%%%%%%
%   %    %
% % % %% %
% %    % %
%  %P%   %
%        %
% %%%% % %
%  .   % %
%%%%%%%%%%